1111111
1P00001
1C00001
1E00001
1111111
