1111111
10000P1
1C00001
1E00001
1111111
