1111111111111111111111111
1CC0000100000000000000001
10000C000000000000C000C01
100C000000000001000000001
100P0000C0000001000000001
1000000000000001000000001
1000000000100000000000001
100000000010C000000000001
1000000000011000000000001
1000000000000000000000001
100E00000000CC0000C000001
1000000000000000000000001
1000000000000000000000001
1000000C00000000000000001
1000000000000000000000001
1111111111111111111111111
