1111111111111111111111111111111111111111111111111111111111111111111111111111111111
100000000000000000000000000000C00000000000000000000000000000000000P000000000000001
1000000E0000000000000000000000C000000000000000000000000000000000000000000000000001
1111111111111111111111111111111111111111111111111111111111111111111111111111111111
