1111111111111111111111111111111111111111111111111111111111111111111111111111111111
10000000000000C000000000000000C0000000000C000000000000C000C0000C00P000000000000001
1000000E0000000000000000000000C000000000000000000000000000000000000000000000000001
1111111111111111111111111111111111111111111111111111111111111111111111111111111111
