1111111111111111111111111111111111111111111111111111111111111111111111111111111111111111
100000000000000000000P00000000000000000000000C000000000000000000000E00000000000000000111
1111111111111111111111111111111111111111111111111111111111111111111111111111111111111111
