1111111111111111111111111111
1000000000000100000000000001
100000C000000100000000000001
10000000000C0100000000000001
1000000000000111100000000001
100P000000000000E00000000001
1000000000000000100000000001
1111111111111111111111111111
