11111111111111111111111111111111111111111111111111
1000000000000000CCC0CCCCCCCCCCCCCCC0CCCC1110000111
11111111111111111111111111111101111111111111111111
1CCCCCCCCCCCCCCCCC0C0C0C0C0C0CCCCCCCCCCCCCCCCCCCC1
1000000000000000000000000000000000000000C000000001
11111111111111111111111111111111111111110000000111
1E000000000000000000000000000000000000000000000001
10000000000000000000000000000000000000000000000001
1CCCCCCCCCCCCCCCCCCCCCCCCCCCCCCCCCCCCCCCCCCCCCCCC1
1P111111111111111111111111111111111111111111111111
11111111111111111111111111111111111111111111111111
