1111111111111111111111111111
100000000000010000000000E001
1000000000000100000000000001
10000000000C0100000000000001
1000000000000111100000000001
100P000000000000000000000001
1000000000000000000000000001
1111111111111111111111111111
