11111110
1C000001
1000C0P1
100E0001
11111111
