11111111
1CCCCCC1
1CCCCCC1
11111111
