111111111111
1000001
100000111111
1P000C0000E1
111111111111
