111111111111
10E000000001
100000P00001
1000C0111111
1111111
