11c111
100001
1P00C1
1E0001
111111
