111111
100001
1Px0C1
1E0001
111111
