11111111111
110000P0001
1010C000001
10010000001
10001111001
1E000001001
11111111111
