11111111
10000001
1000E111
1C00C011
11111111
