11111111
1P000001
1000E1P1
1C00C011
11111111
