11111111
10000001
100000P1
1C00C001
11111111
