11111111
1E000001
100000P1
1C0EC001
11111111
