11111111
10000001
100000P1
100E0001
11111111
