11111
1P0E1
1C001
100P1
11111
