11111
100E1
1C001
1E0P1
11111
