11111
1000E
1C001
100P1
11111
