111111
1000C1
100P01
111101
111011
100001
10E001
111111
