11111
100E1
1C001
100P11
11111
