11111
10E01
10001
11111
10001
1C001
100P1
11111
