1111
1001
10E1
10C1
10P1
1111
