111111
100001
10E001
10C001
10P001
111111
